 #####
 #   ##
## #  ##
# * #  #
#.@$ # #
# *  # #
###    #
  #  ###
  ####
