     #
    #.#
   # $ #
  #     #
 #  ***  #
#.$ *@* $.#
 #  ***  #
  #     #
   # $ #
    #.#
     #
