 #######
 #     ##
 # ###  ####
 #   ##    #
 #  $ #### #
####$ .....#
#  #  #### #
####$$#    #
 #  $ # ####
 #  @ # #
 # #### #
 #      #
 ########
