 ######
 #. . #
 #  *.##
###$ @ #
# $  $ #
#   ####
#####
