########
#  #   #
# $$*. #
# .  . #
# .*$$@#
#   #  #
########
