##### #####
#   ###   #
#    ##   #
##    $$ ##
 #  #  $ #
 ###  #  #
   # @####
   #    #
 ### ## #
 #    # #
 #.. .# #
 ## ### #
  #     #
  #######
