######
#    #
# #$@#
# .*.#
# #$ #
#    #
######
