      #######
      #     ##
      # $ $  #
  #########  #
### $ *.$.* ##
#   $ . . . #
# $ #@.#.#.$#####
#   # . . . #   #
##### * $ *  $# #
   #  ######    #
   #  $ $ ## # ##
   ##     ##   #
    ############
