    ####
 ####  #
 #. .  ##
 #  # @ #
 ## #   #
 ## ##  #
 # $  ###
 #  $ #
 # # ##
 #   #
 #####
