     #####
    ##   #
    #  # #
    #  @ #
    #    #
  #####.###
  #    .  #
### #$#.  #
#  $$  ####
# #    #
#   ####
#####
