   ####
 ###@ #
 #    ##
##$#.. #
#  $ # #
# # $  #
# ..#$##
##    #
 #  ###
 ####
