 ####
##  ###
#  .  ##
#  .#  #
# $*$$ #
###.  ##
  #  @#
  #####
