    ####
 ####  #
 #     #
##.# # ##
#@$ $#  #
# .$    #
##.$##  #
 #. #####
 ####
