  #########
  #       #
### # # # ###
#  $.$.$.$  #
# #.$.$.$.# #
#  $.# #.$  #
# #.$ @ $.# #
#  $.# #.$  #
# #.$.$.$.# #
#  $.$.$.$  #
### # # # ###
  #       #
  #########
