      # #
 #############
 #    .$.    #
##.$  $.$  $.##
 #$.*** ***.$#
##.$  $.$  $.##
 #@   .$.    #
 #############
      # #
