    #####
    #   #
   ##.$.##
  ## $ $ ##
### $.$.$ ###
# .$.*.*.$. #
# $ $.#.$ $ #
# .$.*.*.$. #
### $.$.$ ###
  ## $ $ ##
   ##.$.##
    # @ #
    #####
