 #######
 #     #
## #$# ##
# . $ . #
# $. .$ #
### * ###
# $.@.$ #
# . $ . #
## #$# ##
 #     #
 #######
