     ####
  ####  #
  #  #  #
  # $$$ #
###.....#
#  #$.$##
#   $. ###
# $  . @ #
####$.$  #
   #  ####
   ####
