 #####
 #   #
##.# #
#  @ #
#  $ #
# #*##
#   #
#####
