#####
#   ####
# #$.  #
#  .$#@#
###$.  #
  #  ###
  #  #
  ####
