 ##### #####
 #   ###   #
 #@$  ##.. #
###$#      #
#   ## ##  #
#       ####
#   #   #
#########
