   ####
   #  #
  ## $###
  #  .  ###
### .$.   #
# $.$@$.$ #
#   .$. ###
###  .  #
  ###$ ##
    #  #
    ####
