 #######
#   .   #
# #$#$# #
# $. .$ #
#.#   #.#
# $. .$ #
# #$#$# #
#   +   #
 #######
