###########
#   @ #   #
# $ $ # # #
####$...  #
   # .# * ###
   #$...$#  #
   # .#.$ $ #
   #$.$$.   #
   #  #  ####
   ####$ #
      #  #
      ####
