####
#  #####
# @$ $ #
# ...  #
##$.$ ##
 # .$##
##$. ###
# ...  #
# $ $$ #
#####  #
    #  #
    ####
