 #####
 #   #
## # ##
# $   ##
#  $#. #
## $ . #
 #  #. #
 #### @#
    #  #
    ####
