 ##########
 #  ##    ##
 #     ##  #
 # # $#  # #
 # #  @ $# #
 # #  #$   #
 # ###  ####
## .   ##
#  .####
#  .#
#####
