            ##### # #####
           ##   ######  ##
          # #           # #
         ##### #######  ####
        ##   #  #   ## ##  ##
       # #      # # #      # #
      ##### ##  ## ##   #  ####
     ##   #  ####   ##### ##  ##
    # #      # #     # #      # #
   ##### ##  ##  #    ##   #  ####
  ##   #  ####   # #   ##### ##  ##
 # #      # #    # #    # #      # #
##### ##  ##     # # #   ##   #  ####
#   #  ####   ## #   #    ##### ##  #
#      # #         # # #   # #      #
## ##  ##   ######   # #    ##   #  #
## #####           # #       ##### ##
 # #  #   ### # ## # # #####  #  # #
## # #            @            # # ##
 # #  #  ##### # # ## # ###   #  # #
## #####       # #           ##### ##
#  #   ##    # #   ######   ##  ## ##
#      # #   # # #         # #      #
#  ## #####    #   # ##   ####  #   #
####  #   ##   # # #     ##  ## #####
 # #      # #    # #    # #      # #
  ##  ## #####   # #   ####  #   ##
   ####  #   ##    #  ##  ## #####
    # #      # #     # #      # #
     ##  ## #####   ####  #   ##
      ####  #   ## ##  ## #####
       # #      #   #      # #
        ##  ## ## # #  #   ##
         ####  ## # ## #####
          # #   $ # .   # #
           ##  ######   ##
            ##### # #####
