#######  ####
#     #  #  #
## $  ####$ ##
 ## $ .... $ ##
  ##  ####  @ ##
   #  #  #     #
   ####  #  ####
         ####
