####
#   ###
# .$. #
# $*  #
 #  *$ #
 # .$. #
 ###  @#
    ####
