      ###
      ###
      ###
     #   ##
   ##  . ##
   ## $*$  #
###  $#.#$  ###
### .*.@.*. ###
###  $#.#$  ###
   #  $*$ ##
    ## .  ##
    ##   #
      ###
      ###
      ###
