###### ####
# .  ###  #
#      @  ##
#....# $#  #
###### $   #
     ##$ $ #
      #   ##
      # $##
      #  #
      ####
