 ######
##    #
#  ## #
#@# $ #
#  *..#
## #$###
 #     #
 ###   #
   #####
