     ## ##
 #############
##   .   .   ##
## $$*$$$*$$ ##
 #.....*.....#
## $$*$$$*$$ ##
##@  .   .   ##
 #############
     ## ##
