 #### #####
##  ###   #
#  . #  $ #
# . .$ $ ##
###*## # #
  #  # @ #
  #  #####
  #  #
  ####
