                      ####   ##### ####
    #####  ########   #  #   #   ###  #
    #   ####  #   #####  #   #        #
#####         #          ######## ##  #
#   #####     ## ###### ##  #   #  # ####
#         #####  #   #      #      # #  #
## ###### ##  #      #   #  ## ##  # #  #
 # #   #      #  ## ###### ###  #### #  #
##     #   #  ####  #   #       #  # # ##
#  ## ###### ##  #      #   ##  #      #
#  #  #   #      #  ## ##########  ##  #
#  #      #   #  ##### ##    #  ## ##  ##
####  ## ###### ##  ## #     #      #   #
   ##### ##  #         #  ####  #   #   #
   #   #  #  #   ##  # ## #  ## #########
   #      #  #########  # #      #   #  #
##### ##  #             # #  #   #      #
#   #  #####  ####  #  ## ## ###### ##  #
#      #  #####  ## ####  ##  #   #  # ##
### #  #          #  #    #   #      # #
  # ####  ### ##  #### ## #  ### ##  # #
  # #  ## ###  # ## ####  ## ###  #### #
  # #      #   #    #  #          #  # ###
 ## #  #   #  ##  #### ##  #####  #      #
 #  ## ###### ## ##  #  ####  #####  #   #
 #      #   #  # #             #  ## #####
 #  #   #      # #  #########  #      #
 ######### ##  # ## #  ##   #  #  #   #
 #   #   #  ####  #         #  ## #####
 #   #      #     # ##  ## ###### ##  ####
 ##  ## ##  #    ## #####  #   #      #  #
  #  ##  ########## ##  #      #   #  #  #
  #      #  ##   #      #  ## ###### ##  #
 ## # #  #       #   #  ####  #   #     ##
 #  # ####  ### ###### ##  #      #   # #
 #  # #  ## ##  #   #      #  ## ###### ##
 #  # #      #      #   #  #####$.@      #
 #### #  #   #  ## ###### ##     #####   #
   #  ## ########          #         #####
   #        #   #  #####   #  ####   #
   #  ###   #   #  #   ########  #####
   #### #####   ####
