    #####
 ####   #
 #   $  #
##  #$###
# * .  #
#  * #@#
### .  #
  #  ###
  ####
