    ############
   ##     ##   #
   #  $ $ ## # ##
   #  ######    #
##### *   .  $# #
#   # .#.#. #   #
# $ #@.#.#.$#####
#   $ . . . #
### $ $.$.$ ##
  #########  #
      # $ $  #
      #     ##
      #######
