       ####
 #######  #
##   ##   #
#    #  $ #
# # ##$  ##
# #   $ ##
#@# .#$ ##
#  ..  ##
###. ###
  #  #
  ####
