       #
 #############
 #  .     .  #
 # .$.$$$.$. #
##.$$$.*.$$$.##
 # .$.$$$.$. #
 #@ .     .  #
 #############
       #
