      ###
 #############
 #  $.   .$  #
##  * .$. *  ##
##  $.$*$.$  ##
##  * .$. *  ##
 #@ $.   .$  #
 #############
      ###
