   ####
  ##  ##
 ## *  ##
## $ .$ ##
#  . @ * #
# *   .  #
## $. $ ##
 ##  * ##
  ##  ##
   ####
