        ####
 ###### #  #
 #    ###$ ##
 ## @ ... $ ##
  ## $###    ##
   #  # #     #
   #### #######
