#########
#       #
# $.$.$ #
# .$.$. #
##$.@.$##
# .$.$. #
# $.$.$ #
#       #
#########
