  ## ## ## ##
 #############
##  . . . .  ##
## $.$.$.$.$ ##
 #*$$$ * $$$*#
## $.$.$.$.$ ##
##@ . . . .  ##
 #############
  ## ## ## ##
