    #####
   ##   #
   #  @ #
#### # ##
#. .  . #
#  ###  #
## $ $ ##
 #  $ ##
 ###  #
   ####
