 ####
 #  ###
 # $* #######
 #  . $ #   #
### # . $ # #
#   .*#*.   #
# # $ . #@###
#   # $ .  #
####### *$ #
      ###  #
        ####
