#####
#   #####
#   $ $ ###
## $    $ ##
 ###### .. #
     #. . @#
     #     #
     ###  ##
       ####
