      #####
    ###   #
    #   # #
    # #   #
##### $ $#####
#   ## # #   #
# # $ ... $# ##
#    #.@.#    #
## #$ ... $ # #
 #   # # ##   #
 #####$ $ #####
    #   # #
    # #   #
    #   ###
    #####
