     ####
   ###  ###
  ## $$ $ #
 ## ...   #
 # .## $ ##
##$.$.*$##
# $.##.  #
#   ...  #
## $ $$@##
 ###  ###
   ####
