   ####
####  #
#@.*  #
#  #  ###
####  $ #
   #  # #
   ##   #
    #####
