#########
#   #   #
# $...$ #
# $*@*$ #
# $...$ #
#   #   #
#########
