 #######
##     ##
# $.$.$ #
# .$.$. #
# $.@.$ #
# .$.$. #
# $.$.$ #
##     ##
 #######
