      #####
   ####   #
####  $*. #
#  $*.   ##
# @   #####
#  ####
####
