###########
#  ##     #
# $   $ #.#
#  ### ##.#
## ###  #.#
# $   $ #.#
#   ##  #.#
### #####.#
###$#  $ .#
#         #
# $#  # @ #
#     #   #
###########
