            ####
          ###  ###
         ##.$.   #
        ##.$.$$. #
       ##.$.$$.$##
      ##.$.$$.$.#
     ##.$.$$.$.##
    ##.$.$$.$.##
   ##.$.$$.$.##
  ##.$.$$.$.##
 ##.$.$$.$.##
##.$.$$.$.##
#.$.$$.$.##
## $$.$.##
 #@  $.##
 ####.##
    ###
