########
#  #   #
#  #.. #
# $$$$$#
#  #...#
#  #   #
#  @   #
########
