  ######
  #    #
### ## #
# ...  #
#  $ ###
# #$##
#  $ #
#  @ #
######
