########
# .  . #
#.$$$$.#
# $..$ #
# $.+$ #
#.$$$$.#
# .  . #
########
