   ####
 ###  ##
 # $ $ #
 #   # #
 ##$   #
  #  # #
  ## # #
  #. # #
  #.## #
###.## ##
#       #
#   @   #
#########
