 ########
 #  #   #
##  #$  #
# .*@*. #
#  $#  ##
#   #  #
########
