        ####
        #  #
      ###  #
     ##    #
     #  #$###
     # $ $  #
     ##$    #
#######  ####
#     #  ##
#  @  ##  #
#  #  ....#
#    ######
######
