#####
#   ###
# # $ ###
# # $   #
# #.$##@#
# #.$   #
#  .#####
## .  #
 #    #
 ######
