  #####
  #   ###
 ## #   ###
 #  .$#   #
## #$.$.# #
#  $.@.$  #
# #.$.$# ##
#   #$.  #
###   # ##
  ###   #
    #####
