#########
#   #   #
# # # # #
#  *$*  #
###.@.###
#  *$*  #
# # # # #
#       #
#########
