  #####
  #   #
  #   #
  #  ###
###. # #####
#  . ###   #
#  . # $   #
# #.## $ $ #
#  . @  $$##
##  ###   #
 #### #####
