         #####
         #   #
########## # #
#.     #  $  #
#.  @  #    ##
#.# #######  #
#         $$ #
##  #####    #
 ####   ######
