     ####
     #  ###
    ## .  ##
    #. .   #
    #.  #@ #
    ## ##  #
   ##  #####
  ## $ #
 ## $  #
## $  ##
# $  ##
#   ##
#####
