            ####
           ##  ###
          ##  @  #
         ##  *$ .#
        ##  **  ##
       ##  **  ##
      ##  **  ##
     ##  **  ##
    ##  **  ##
   ##  **  ##
  ##  **  ##
 ##  **  ##
##  **  ##
#  **  ##
# **  ##
#  ####
####
