  #######
###  #  ###
#   $*$   #
# # .$. # #
# #$.+.$# #
# # .$. # #
#   *$*   #
###  #  ###
  #######
