 ####
 #  #######
 # $* #   #
 #  ..$ # #
### # *   #
#   * #@###
# # $..  #
#   # *$ #
#######  #
      ####
