  ####
###  #
# $.@##
#  *  #
#  *  #
#######
