  #####
### . #
#  . $##
#  $$. ###
### .$$@ #
  ##$ .  #
   # . ###
   #####
