#####  #######
##  ####  ####
##    #  $   #
## #  #  ### #
#  # ###   #.#
#  #     $ #.#
#  #  ###  # #
## #  # ## #@#
#  ####  # # #
#        # #.#
######## ###.#
#    # #$$ # #
# ## #       #
#    #   #   #
##############
