 ####
##  ###
# .$  #
#@.$  #
# .$ ##
##  ##
 ####
