  ########
  #  #   #
  #  $   #
  #  ##$##
#### ##  #
# @...#$ #
#        #
######  ##
     ####
