 ######    ####
 # @  ######  #
 #  #   $     #
## ....# $ #  #
#   ## ## $  ##
#      ### $ #
######## ##  #
          ####
