######
#    #
# ##$###
# # $  #
# @.*. #
##     #
 #  ####
 ####
