  ####
 ##  #######
##  * $ #  #
#  * *  ** ##
#     #@.*  #
###  ## **  #
  ######   ##
       #   #
       #####
