  ########
  #  #   #
###... . #
#    # ###
# @    #
###  # ##
  ### $ #
  ## $  #
### $  ##
#  $  ####
#    #   #
#  ##    #
#       ##
##  #  ##
 ####  #
    ####
