########
#  ##  #
#  ..  #
# .  . #
### ####
 #    ##
 # $$@ #
 ### $ #
###  # #
#    $ #
#    ###
######
