 ####
 #  ###
##    ##
#  * . #
# *$*$ #
## .$. #
 #@  ###
 #####
