     #####
     #   #
     # # #
     #   #
#######$ #
#    $..$#####
# # $.  .#   #
#   #.  .$ # #
#####$..$    #
    # $#######
    #   #
    # # #
    # @ #
    #####
