#####
#   #######
#   ...   #
## $ $ $  #
######@####
#  $ $ $ ##
#   ...  #
#######  #
      #  #
      ####
