    ####
    #  #
  ###$.##
###     #
# .  *  ###
# $ *@* $ #
### *** . #
  #     ###
  ##.$###
   #  #
   ####
