  ## # ## # ##
 ##############
##            ##
##**.**$$$*.**##
 #  $. ..$.$  #
 #  $.$.. .$  #
##**.*$$$**.**##
##@           ##
 ##############
  ## # ## # ##
