#####
#   ####
#  .#  #
## ..  ##
 # ## @ #
 # #    #
 # $ ####
 # $##
 # $ #
 #   #
 #####
