   #####
   #   ##
 ### #  #
##  $ # #
#  .*.  #
# # $  ##
#  #@###
##   #
 #####
