     ####
     # @##
###### $ ##
#  . # $  #
#      $# #
## ..#    #
 ##  ######
  ####
