 #####
 #   #
 #   ##
 #$*$ #
##. . #
# .@.##
# $*$#
##   #
 #   #
 #####
