#######
#     #
# $$$.#
## #@.#
 # # .#
 #  # #
 ##   #
  #####
