#########
###    ##  ####
#    * ##  #  #
# ****  ####$.##
#  *@*      $. #
#  **** ####   #
## *    #  #####
##    ###
#########
