   ###  #####
#### ####   #
#  ###      #
# ..  $$$$  #
# ..  # @#  #
#############
      #  #
