 #######    #####
 #     ######   #
##      @ ...   #
#  ########## ###
# $  $   $     #
#  #   #   #   #
################
