   ####
   #  #####
   # @$ $ #
   # ...  #
#### $.$$ #
#   ##. ###
#   .$.##
### #.  #
 #  $ $ #
 #  #####
 #  #
 ####
