 #####
 #   ##
 #$#@ #
 # $  #
##  ###
# $.  #
#. .  #
#######
