   #####
 ###   #
##     #
# **$ ##
#  * .#
### #@#
  #   #
  #####
