   #####
  ##   #
### .# #
#  $*$@#
#   .# #
### #  #
  #   ##
  #####
