 ######
 # @  #
 # *$ #
 # .###
## $$ #
#  .. #
#   ###
#  ##
#####
