 #######
 #     #
 # $$  #
 #  $###
 # #  #
 # #$ #
 # #  #
## ## ##
#    ..#######
#@###...     #
#   #.#### $ #
### #.# $ $$ #
  #  .    #  #
  #########  #
          ####
