######
#.#  #
#@$$ #
#..$ #
##   #
 #####
