#############
#    ###    #
# $$ $ $ $$ #
### .#@#. ###
  # ..  . #
  ##.#*#.##
  # .  .. #
### .# #. ###
# $$ $ $ $$ #
#    ###    #
#############
