   ####
   #  #
   #  ##
  ##$. ####
### $.$$  #
#  ..@..  #
#  $$.$ ###
#### .$##
   ##  #
    #  #
    ####
