########
#      #
# ###$ #
# #  $ #
# #.*$@#
# #.#  #
#  .#  #
########
