######
#  @ #
# #$ #
# .*.#
###$ #
#  * #
#    #
###  #
  ####
