   #######
  ## .   #
 ##  .   #
 # $*.# ##
 # # .  #
## # . ##
#  ### #
# #   @##
# $$$#  #
#     # #
###   # #
  #$##  #
  #    ##
  ######
