#########
#       #
# *$*$* #
# $...$ #
# *. .* #
# $...$ #
# *$*$* #
#      @#
#########
