     #####
     #   ##
######  $ ##
#    ##  $ ##
#     ##  $ #
#...#  ##   #
#   @  ##$  #
#...# ## $ ##
##### # $  #
    #     ##
    #  ####
    ####
