 #####
 #   #
 #$#@#
## $ #
#   ##
#.*. #
#    #
######
