######
#    #
# $$ ###
### @  #
  #  . #
  ## .##
   ####
