  #####
 ##   #
 #  # #
##    #
#  $ ####
#  $$#. #
###$    #
  #  #  #
  ####. #
   #@#. ##
   #  .  #
   #     #
   #######
