    #######
  ####   ####
#### $ # $ ####
#  #  $ $  #  #
#      #      #
#* ######### *#
#  ....@....  #
#* ######### *#
#      #      #
#  #  $ $  #  #
#### $ # $ ####
  ####   ####
    #######
