  # # # # # #
 #############
##  .  .  .  ##
 # $$* $$* $ #
##.*.* * *.*.##
 # $ *$$ *$$ #
##@ .  .  .  ##
 #############
  # # # # # #
