    ####
  ###  #
  # $$ #
 ## #  #
## .#$@#
#      #
# ..####
#####
