  #####  #####
 ##############
## $ . $. $ . ##
##  $ $.$. .  ##
##.$.$.  $.$.$##
##$.$.$  .$.$.##
##  . .$.$ $  ##
##@. $ .$ . $ ##
 ##############
  #####  #####
