     ####
 #####  #
 # $ $$ #
 # ..*  #
###.#$# #
# $..@  #
#  . $###
###.  #
  ##$ #
   #  #
   ####
