  ####
###  #
#  . ##
# #*  #
# $.#@#
##$.# #
#  $  #
#   ###
#  ##
####
