#### ####
#  ###  ######
#  #         #
####$  $## # #
 #   #   # $ ##
###    ## $$  #
#  ## $   #   #
# @ #  ########
#     ##     #
#......# ######
#      ###    #
######## ######
