#####    #####
#   ######   #
#          # #
## ####### # #
 # #     # # #
 # #$$ ..... #
## #   #######
#  #$#@#
# $ $  #
#  #  ##
####  #
   ####
