#######
#  @  #
# $ $ #
##.*.##
##   ##
# $.$ #
# .$. #
#  #  #
#######
