 #####
 #   ####
 # # #  #
 # $.*  #
 # .$ * #
###*#$.@#
#  .$.$ #
# #$.$. #
#    #  #
######  #
     ####
