############
#   .#  #  #
#   .#    $###
# @#.# $#  $ ##
#   .   # $   ##
#  ##### ##    #
####   ##    # #
        # #  # #
        #  ##  #
        ##    ##
         ######
