#######
#     #
#.### ###
#.# $ $ #
#.#  $  #
#.# $ $ #
#.###@ ##
#      #
#  #####
####
