  ####
###  ###
#      #
# $ $ $#
#*.*.*.#
# $ $ $#
#*.*.*.#
# @    #
########
