  #####
 ## . ##
##.$ $.##
# $ * $ #
#. *@* .#
# $ * $ #
##.$ $.##
 ## . ##
  #####
