 #######
 #  #  #
 #  #$ #
##  .*+#
#   #$ #
#   #  #
##  ####
 #  #
 ####
