###########
#         #
#  * . *  #
##*$*@*$*##
#  * . *  #
#    #    #
###########
