 ####
 #  #####
 #  $ $ #
## #*.. #
#  .   ###
# $$..$$ #
###   .@ #
 # ..*# ##
 # $ $  #
 #####  #
     ####
