   ####
   #  #
   #$ #
   #  #
####@###
#  $   #
#  ..* #
#   #  #
########
