      #
     # #
    #   #
   # .$. #
  # .$.$. #
 # .$ $ $. #
#  $.$@$.$  #
 # .$ $ $. #
  # .$.$. #
   # .$. #
    #   #
     # #
      #
