########
#  $.  #
#  $.  #
###  ###
#  $.  #
#@ $.  #
########
