    ####
#####  #
# $.$ *#
#  . . ###
###*. $$ #
 # .@.   #
##$. $.###
# $ #$ #
#      #
########
