   #####
   #   #
####   #
#  ..$##
#  ..$ #
##$#@# #
# $    #
#   ####
#####
