    ####
#####  #
# $ $$ #
# ..*  #
##. $# #
 #..@  #
##. $# #
# ..*  #
# $ $$ #
#####  #
    ####
