  ######
  # @  #
###$.  #
# . $###
# #$. #
# # # #
#     #
##   ##
 #####
