#####
#   ##
# #  #
# #$.###
#  .$  #
# #$.# #
# #.$# #
#  $. @#
###.$# #
  #  # #
  ##   #
   #####
