       ####
  ###### .#
###       #
#  $$ # ..#
# $  #  .##
#  $$# #.###
###  #     #
  #    # # #
  ##### @  #
      #   ##
      #####
