    #####
 ####   #
 #   $  #
##  #$###
# * .  #
#  * #@#
##  *  #
 # * .##
 ##   #
  #####
