   ####
 ###  ##
 #     #
##*  # #
# *$*. #
#  @  ##
#######
