 ######
 #    ###
 # $  $ #
 ##$# # #
### #@# ##
# . . .  #
#   ##   #
##########
