   ####
   #  ###
   # .  #
   #$.@ #
#### .$ #
#  $$.###
#     #
#######
