 #######
 #  #  ###
 #  #  . ###
 #   $ # @ #
 ## # $ $  #
  # ##..####
  #  #  #
### ### ###
#     $   #
#   ###.  #
##### #####
