#####
#   #
#   ###
#$$$@ #
#...  #
#######
