     ####
     #  #
 #####  #
 #  $ $ #
 # .#  ###
 # .#$$  ##
## .#     #
#  *###@  #
#        ##
## .######
 ####
