       ####
########  #
#     $   #
#  ##.##  #
##$##  . ##
 #  . $# ##
 # ###.#  #
 # ### @  #
 #   $ ####
 #  ####
 ####
