   ######
####    #
#    ## ##
# ##     #
# #  #   #
#  $$#$$ #
###$ $ $##
 ##     ##
 ####@####
 #  . .. #
 # .. .  #
 # .##   #
 #####   #
     #####
