     #####
 #####   #
##  +  # #
# $$.$$  #
#  #.# ###
##  .  #
 #######
