  #####
###   #
#  $# #
#  .$ #
## ##.#
 #   @#
 ######
