     # # #
 #############
 # $       . #
 # .**   **$ #
## *  ***  * ##
 # $**   **. #
 #@.       $ #
 #############
     # # #
