   ####  ####
####  ####  #
#   $   ... #
#  $ $   #  #
#### #### . #
  # $  @  ###
  #   #####
  #####
