########
#      #
# #.#  #
#  *   #
##$*$ ##
#  *@##
# #.##
#   #
#####
