#########
#  ##   ##
# $ $$*@ #
#  # . # #
## #. .  #
 #   #####
 #####
