  #####
 ##  #####
 ##      #
 # .**$  #
## #  #@##
#  $**. #
#      ##
#####  ##
   #####
