 ##########
 #        #
 #.####   #
##.$ @ $$ #
# .*.$ #  #
# ### ## ##
#        #
##########
