 #####
##   #
#    #
# .$.##
##$#$ #
 #.$. #
 #    #
 # @ ##
 #####
