   ### # ###
 #############
 #     .     #
## .$ $$$.$. ##
##*$.$...*.$*##
## .$.$$$ $. ##
 #@    .     #
 #############
   ### # ###
