    ######
    #    ##
 #### ##  #
##      # #
# @$**. # #
#   # ##  #
#####    ##
    ######
