#####
#   #
#   ######
#$$$$ $ @#
#.....   #
##########
