#########
#   #   #
# .$.$. #
# $.$.$ #
##.$@$.##
# $.$.$ #
# .$.$. #
#   #   #
#########
