    ####
 ####  ##
 #    $ #
 # #  # #
## #$$$@#
# ..  ###
# .. ##
###  #
  ####
