  #######
  #     #
### ### #
# ..*   #
#  $$@ ##
####  ##
   #  #
   ####
