########
#      #
#    # #
###..$.#
  # #$##
  #  @ #
  ## $ #
   # # #
   #   #
   #####
