########
#   #  #
# $.$. #
##.  $ #
# $  .##
# .$.$ #
#  #  @#
########
