     ##### ##################
    #     #                  #
   #  #  #  ################  #
  #  #  #  #                #  #
 #  #  #  #  ##############  #  #
#  #  #  #  #              #  #  #
# #  #  #  #  ############  #  # #
# # #  #  #  #            #  #   #
# # # #  #  #  ##########  #  #  #
# # # # #  #  #          #  #  # #
# # # # # #  #  ########  #  #  #
# # # # # # #  #        #  #  #  #
# # # # # # # #  ######  #  #  # #
# # # # # # # # #      #  #  # # #
# # # # # # # # # ####  #  # # # #
# # # # # # # #       #  # # # # #
# # # # # # #   ## ##  # # # # # #
# # # # # #  ## ##   # # # # # # #
# # # # #  #    @.$# # # # # # # #
# # # #  #  #### # # # # # # # # #
# # #  #  #      # # # # # # # # #
# #  #  #  ######  # # # # # # # #
#  #  #  #        #  # # # # # # #
 #  #  #  ########  #  # # # # # #
# #  #  #          #  #  # # # # #
#  #  #  ##########  #  #  # # # #
#   #  #            #  #  #  # # #
# #  #  ############  #  #  #  # #
#  #  #              #  #  #  #  #
 #  #  ##############  #  #  #  #
  #  #                #  #  #  #
   #  ################  #  #  #
    #                  #     #
     ################## #####
