   #####
   #   #
####   ###
#  $$$$$ #
#   . .  #
## #.#.###
 # #*+.  #
 ###.#.# ##
 #  . .   #
 # $$$$$  #
 ###   ####
   #   #
   #####
