#########
#   ##  #
#  ..*$@#
## $ .  #
 ###.####
 # .   #
 # ***$#####
 #   $     #
 ####$#    #
   #  ###  #
   #      ##
   #####  #
       ####
