#######
# . . #
#.$$$.#
# $@$ #
#.$$$.#
# . . #
#######
