    ####
 ####  ###
 #     $ #
 #  $$ # #
 # # @#  #
## ####  ##
#  ...    #
# ### #   #
#     #####
#######
