  ####
  #  #
###  ##
#  $ .# ####
#  $#.###  #
#  $ .#    #
#####.# $  #
  ###.#$#@ #
  #  .  $  #
  #   ###  #
  ##  # ####
   ####
