 #####
 #   #
 # # ####
 # $.*  #
 # .$ * #
###*#$.@#
#  .$ * #
# #$.*  #
#    #  #
#   #####
#####
