#######
#  +  #
# *$* #
#. # .#
#  #  #
#  #  #
#  #  #
# $#$ #
#  #  #
#######
