   #####
####@  #
#  $*. #
#     ##
#  #####
####
