                  #####
            ##### #   #
            #   ### # #
      ##### # #       #
##### #   # #   #### ##
#   ### # # ### #  # #
# #    @  #   # #  # ###
#   ####$###### ####   #
### #  # .      #    # #
  # #  #  ##  #    #   #
 ## #####  ##    # #####
 #         ##  ### #
 # # ### #  #####  # #####
 #   # #    # #    # #   #
 ##### #  #####  # ### # #
       # ###  ##         #
   ##### #    ##  ##### ##
   #   #    #  ##  #  # #
   # #    #        #  # ###
   #   #### ###### ####   #
   ### #  # #   #       # #
     # #  # ### # # ###   #
    ## ####   # #   # #####
    #       # # #####
    # # ###   #
    #   # #####
    #####
