   ########
   #   #  #
   #      #
 #####$## #
 #   # ## #
 #   #  #.#
 ##  $  #.#
  #  #  #.#
  #$#####.#
### #  ## #
#        @#
# $##  #  #
#      ####
########
