     ##########
     #        ##
 ##### #### $  #
 #.. #     #   #
 #   .  # $  # #
 #.. #### # $  #
 ## ##  # $$#  #
  # #   ##    ##
###@###  ######
#     #
#     #
#  #  #
####  #
   ####
