 #######
 #  ####
 #   $ #
##$#.#.#
#  #@# ##
# $#.#. #
#    $  #
#### #  #
 ###   ##
 #######
