 #######
 #  #  ##
 #.$#$. ##
 #.$ $.  #
 # . . $ #
##$.#.$###
# $ . $ #
# @ #   #
##  #####
 ####
