########
#    @ #
# $  $ #
## ## ##
# $# $#
#  .. #
## .. #
 ######
