 ####
 #  ###
 #$   #
 # .# #
##*.  #
# $ ###
# @ #
#####
