 #####
 # . #####
 #$ $$ $ #
 # .. . .#
##$   .$ #
# $.   $##
#. . .. #
#@$ $$ $#
##### . #
    #####
