 #########
##  #  ####
##.$#  *  #
#   @ * * #
#   #  *  #
######* ###
    ##   ##
    ##   ##
     #####
