################
#  #  #  #  #  #
#  .  #  #  #  #
# $#  *  #  #  #
#  #  # @*  #$ #
#  #  #  #  .  #
#  #  #  #  #  #
################
