  ##########
  #   #    #
### ... .# #
#    ## ## #
#    ##  # #
###  #@  # #
 ##  ##  # ###
  ##### $#$  #
   ## # $    #
    ### $##  #
     ##  #####
      ####
