#####
#   ###
#     #
#     #
###.###
# $*$ #
#  +  #
#######
