#####
#@  ######
#  $ #   #
#.*.*. $ #
#  $ #####
##   #
 #####
