############
#         @#
# #$###### #
# #.#   .$ #
# # .$ .## #
# #  ##$ # #
# # $##  # #
# ##. $. # #
# $.   #.# #
# ######$# #
#          #
############
