 #######
 #     ###
## ###$  #
#  .. $  #
#  .##$ ##
### # @##
  #   ##
  #####
