######
#    ###
# $ @  #
#  ### #
# $$ $ #
#     ###
### ##  #
# ....  #
#       #
#  ######
####
