########
#   #  #
#  $*$ #
#  .$. #
###.  ###
 # .@.  #
 # $*$  #
 #  #   #
 ########
