### #######
## ####   #
# ## ...# #
 ###$   # #
##  $$### #
## @      #
###########
