#########
#   #   #
# $ * $ #
#..# #..#
# $ # $ #
# .$@$. #
# $ # $ #
#..# #..#
# $ * $ #
#   #   #
#########
