 #####
 #   #
## . #
#  * #
# # ##
#  $ #
## * #
 # @ #
 #####
