   ####
   #  ##
   #  ###
   #  . #####
  ## $*$    #
 ## $#.#$   #
###.*.@.*.###
#   $#.#$ ##
#    $*$ ##
##### .  #
    ###  #
     ##  #
      ####
