 ######
 #  . ###
## $.   #
#  $*$$ #
#..*@*..#
# $$*$  #
#   .$ ##
### .  #
  ######
