       ######
    ####    ###
    #    ##   #
 #### ###..## ####
 #  #$$     #    #
##  $ $ #... @ # #
#  #  $ ##### #  #
#    ####  #    ##
##   #     #   ##
 #####     #####
