 #####
##   ##
# .$. #
# $#$ #
# .$. #
#    ##
## @##
 ####
