           #######
          ##     #
         ##  ### #
         #  $ $  ##
         # $ $ $  #
 #########  ###   #
 # . . . # ## #####
##        @  $ #
#  . . . # #   #
# ######## #####
#          #
############
