 #####
## @ ####
#  #  . ##
# #      #
# $$ #.  #
##    ####
 ##   #
  #####
