 ######
 #    #
 #. ..##
###$ @ #
# $  $ #
#   ####
#####
