    ####
 ####  #
 #  #  #
##$.#$.###
# $.$ .  #
#  .#$.$ #
##$.@ .$##
 # $*.  #
 ##   ###
  #   #
  #####
