  ####    ####
 ##############
##   ..  ..   ##
## $*$*$$$$*$ ##
 # *. .. .$.$ #
 # $.$. .. .* #
## $*$$$$*$*$ ##
##@  ..  ..   ##
 ##############
  ####    ####
