#######
#  #  #
#.$#$.###
# * *   #
#  .  $ #
## * ####
#  * #
#  @##
#####
