####
#  #
#  ###
# $$@#
## . #
 #$.##
 # .#
##$.####
#  ... ##
# $ $$  #
#  ##   #
#########
