    ####
    #  #
    # $#
  ###  #
  # $ $###
  # ..$  #
  ##.@*  #
   #.. ###
####.$$###
#   . $  #
#   ##   #
######  ##
     #  #
     ####
