   ####
####  #
#  #  #
# . . #
# @$$ #
# # ###
#   #
#####
