#############
#       #   #
#    ## #   #
## ### $ $ ##
#@...# $$$ #
#          #
##..########
 ####
