       ####
       #  ###
       # .. #
       # $$ #
    ##### ###
    ##  #   #
    #       #
 ####  ##$.##
 #  ##@##  #
##.$##  ####
#       #
#   #  ##
### #####
# $$ #
# .. #
###  #
  ####
