   ####
  ##  #
  #   #####
  #       #
  #   #   #
  ##    .##
   #####.#
  ######.###
  #     .  #
###  #$#.  #
#  $$ $ ####
#   $ @ #
###  ####
  ####
