 #######
 #     #
## **$ ##
# $.$.  #
# #.@.# #
#  .$.$ #
## **$ ##
 #     #
 #######
