####
#  ####
#  #  #
#.$**@#
##    #
 #   ##
 #####
