######
#    #
# ## ##
# # * ##
# #@*  ##
# # *   #
# # * $ #
# ## #.##
#    ###
######
