  #######
###  #  ###
#   **$ $ #
# # .$.   #
# ##.+ ## #
#   .$. # #
# $ **$   #
###  #  ###
  #######
