  ####
 ##  ####
 #  $$  #
 # #  # #
 # $ $# #
 # #  # #
 #@#  # #
## #$#  #
# .....##
#   ####
#####
