  ### #### ###
 ##############
##            ##
 #$.$  .$.$.$.#
##.$.$.$.$.$.$##
##$.$.$.$.$.$.##
 #.$.$.$.  $.$#
##@           ##
 ##############
  ### #### ###
