########
#   @  #
#   *  #
###.$###
  # * #
  #   #
  #####
